C	215,1,113
R	640 420
EA	./textures/ted.xpm
F	1,57,168

NO	./textures/monke.xpm
SO	./textures/short.xpm
WE	./textures/snf.xpm
S	./textures/HaS.xpm

   1111
 1100011
100010011
100000E001
 11111111
