C	215,1,113
R	640 420
EA	./textures/ted.xpm
F	1,57,168
NO	./textures/monke.xpm
SO	./textures/short.xpm
WE	./textures/snf.xpm
S	./textures/HaS.xpm


1111
1001
1001
10001
10N1
1011
1111
