C	25,58,0
R	640 640
EA	./textures/vsh.xpm
F	100,100,0

NO	./textures/monke.xpm
SO	./textures/short.xpm
WE	./textures/snf.xpm
S	./textures/HaS.xpm

   1111
 1100001
100N01101
1000000001
 11111111
