C	215,1,113
R	400 400
EA	./textures/ted.xpm
F	1,57,168
NO	./textures/monke.xpm
SO	./textures/short.xpm
WE	./textures/snf.xpm
S	./textures/HaS.xpm

11111111
100E0001
10000001
10001111
10001
10011
1000111
11001111
110000001111
1000000000001
1000000000001
1000000000001
1000000000001
10000000000001
10000000000001
10000000000011
10000000000000111
10000000000000001
10000000000001111
11111111111111
