
C	25,58,0
R	640 640

EA	./textures/vsh.xpm
F	100,100,0
NO	./textures/monke.xpm
SO	./textures/short.xpm
WE	./textures/snf.xpm
S	./textures/HaS.xpm


11111
10001
10N01
10001
1111
